1111111111
1000000001
1000000001
1000000001
1000000001
1000000001
1000000001
1000000001
1000000001
1001000001
1001000001
1001111001
1000001001
1000$01001
1111111111
